11111111111111111111111111111111
10000000000000000011000000000001
10000000000000000000000000000001
10000000000000000011000000000001
10000000000000000011000000000001
10000000000000000011011111111101
10000000000000000011000000000001
10000000111110111110000000000001
11110000111000011100000000000001
11111101111000011100000000000001
11100000000000011100000000000001
11100000000000000000000000000001
11100001001000011100000000000001
11110111111110111111011111111011
11000000000000010000000000000001
11000000001000010000000000000001
11100000001000010000000000000001
11100000001000010000000000000001
11100000001000010000000000000001
11111111101000011110000000000001
11100001101000010010110000000001
11100000001000010000011111111011
11100000001000010000000000100001
11100000001000010000000000100001
11100000000000000000000000000001
11111111111111111111111111111111